30
400 400
600 600
5 5
1 1 1 1 1 
1 4 3 3 1
1 3 6 3 1
1 3 3 5 1
1 1 1 1 1
