30
400 400
600 600
5 5
1 1 1 1 1 
1 3 3 3 1
1 3 4 3 1
1 3 3 3 1
1 1 1 1 1
