200
400 400
600 600
9 9
1 1 1 1 1 1 1 1 1
1 2 2 2 1 1 2 1 1
1 2 2 2 2 2 2 1 1
1 2 2 2 2 2 1 1 1
1 2 2 2 4 2 2 1 1
1 1 1 1 1 2 2 1 1
1 2 2 2 2 2 2 1 1
1 1 1 1 1 1 1 1 1
1 1 1 1 1 1 1 1 1
