200
9 9
1 1 1 1 1 1 1 1 1
1 4 2 2 1 1 3 1 1
1 2 2 2 2 2 2 1 1
1 2 2 2 6 2 1 1 1
1 3 2 2 2 2 2 1 1
1 1 1 1 1 2 2 1 1
1 2 2 2 2 2 5 1 1
1 1 1 1 1 1 1 1 1
1 1 1 1 1 1 1 1 1
