100
400 400
600 600
20 20
1 1 1 1 1 1 1 1 1 1 1 1 1 1 1 1 1 1 1 1
1 4 2 2 2 1 1 1 1 1 1 1 1 1 1 1 1 1 1 1
1 1 2 1 2 1 1 1 1 1 1 1 1 1 1 1 1 1 1 1
1 1 1 1 2 2 2 2 2 1 1 1 1 1 1 1 1 1 1 1
1 1 1 1 2 1 1 1 2 1 1 1 1 1 1 1 1 1 1 1
1 1 1 1 2 1 1 1 2 1 1 1 1 1 1 1 1 1 1 1
1 1 1 2 2 2 2 2 2 2 1 1 1 1 1 1 1 1 1 1
1 1 1 2 1 1 1 2 3 2 1 1 1 1 1 1 1 1 1 1
1 1 1 2 1 1 1 2 2 2 6 1 1 1 1 1 1 1 1 1
1 1 1 2 2 1 1 1 1 1 2 1 1 1 1 1 1 1 1 1
1 1 1 2 2 2 6 3 2 2 2 1 1 1 1 1 1 1 1 1
1 1 1 1 1 1 1 1 1 1 2 1 1 1 1 1 1 1 1 1
1 1 1 1 1 1 1 1 1 1 2 5 1 1 1 1 1 1 1 1
1 1 1 1 1 1 1 1 1 1 1 1 1 1 1 1 1 1 1 1
1 1 1 1 1 1 1 1 1 1 1 1 1 1 1 1 1 1 1 1
1 1 1 1 1 1 1 1 1 1 1 1 1 1 1 1 1 1 1 1
1 1 1 1 1 1 1 1 1 1 1 1 1 1 1 1 1 1 1 1
1 1 1 1 1 1 1 1 1 1 1 1 1 1 1 1 1 1 1 1
1 1 1 1 1 1 1 1 1 1 1 1 1 1 1 1 1 1 1 1
1 1 1 1 1 1 1 1 1 1 1 1 1 1 1 1 1 1 1 1
