9999
400 400
600 600
8 8
1 1 1 1 1 1 1 1
1 4 7 8 2 1 1 1
1 1 1 1 2 1 1 1
1 2 2 2 2 1 1 1
1 2 1 1 1 1 1 1
1 2 1 5 1 1 1 1
1 2 2 2 1 1 1 1
1 1 1 1 1 1 1 1
